===============================
=                             =
=                           = =
=                           = =
=                           = =
=                         g = =
=                             =
=                             =
=                             =
=                             =
=       ==                    =
=       ==                    =
=                             =
=                             =
=                             =
=                             =
=                      ========
=                      =  s   =
=                             =
===============================
