==========
==..s...==
===..===.=
=........=
=.====.===
=.==...===
=.======g=
=.==..==.=
=........=
==========
